AA 	Basic-Materials
APA	Basic-Materials
APC	Basic-Materials
APD	Basic-Materials
ASH	Basic-Materials
BHI	Basic-Materials
CUM	Basic-Materials
DD	Basic-Materials
DOW	Basic-Materials
EC	Basic-Materials
EMN	Basic-Materials
EOG	Basic-Materials
FCX	Basic-Materials
HAL	Basic-Materials
IFF	Basic-Materials
MRO	Basic-Materials
NBR	Basic-Materials
NEM	Basic-Materials
NUE	Basic-Materials
OXY	Basic-Materials
PD	Basic-Materials
PX	Basic-Materials
RDC	Basic-Materials
RIG	Basic-Materials
SIAL	Basic-Materials
SLB	Basic-Materials
SUN	Basic-Materials
WMB	Basic-Materials
CBE	Conglomerates
CLX	Conglomerates
GE	Conglomerates
MMM	Conglomerates
PPG	Conglomerates
TXT	Conglomerates
UTX	Conglomerates
ADM	Consumer-Goods
AVP	Consumer-Goods
AVY	Consumer-Goods
BC	Consumer-Goods
BLL	Consumer-Goods
BUD	Consumer-Goods
CAG	Consumer-Goods
CCE	Consumer-Goods
CCU	Consumer-Goods
CL	Consumer-Goods
CPB	Consumer-Goods
CTB	Consumer-Goods
EK	Consumer-Goods
F	Consumer-Goods
GIS	Consumer-Goods
GM	Consumer-Goods
GT	Consumer-Goods
HAS	Consumer-Goods
HNZ	Consumer-Goods
HSY	Consumer-Goods
IP	Consumer-Goods
JCI	Consumer-Goods
K	Consumer-Goods
KMB	Consumer-Goods
KO	Consumer-Goods
LEG	Consumer-Goods
LIZ	Consumer-Goods
MAT	Consumer-Goods
MO	Consumer-Goods
NAV	Consumer-Goods
NKE	Consumer-Goods
NWL	Consumer-Goods
PBI	Consumer-Goods
PCAR	Consumer-Goods
PEP	Consumer-Goods
PG	Consumer-Goods
SLE	Consumer-Goods
TIN	Consumer-Goods
TRW	Consumer-Goods
VFC	Consumer-Goods
WHR	Consumer-Goods
WWY	Consumer-Goods
XRX	Consumer-Goods
ABK 	Financial
AFL	Financial
AIG	Financial
ALL	Financial
AOC	Financial
AXP	Financial
BAC	Financial
BEN	Financial
BK	Financial
CB	Financial
CMA	Financial
COF	Financial
DNY	Financial
EFX	Financial
EQR	Financial
FITB	Financial
FNM	Financial
FRE	Financial
GLK	Financial
HBAN	Financial
HIG	Financial
JPM	Financial
KEY	Financial
KMG	Financial
KRB	Financial
LEH	Financial
LNC	Financial
MBI	Financial
MMC	Financial
MTG	Financial
NTRS	Financial
PCL	Financial
PGR	Financial
PNC	Financial
SAFC	Financial
SFA	Financial
SLM	Financial
SNV	Financial
SPG	Financial
STI	Financial
STT	Financial
TMK	Financial
UNM	Financial
WB	Financial
WFC	Financial
ABT 	Healthcare
AET	Healthcare
AGN	Healthcare
AMGN	Healthcare
BAX	Healthcare
BCR	Healthcare
BDX	Healthcare
BMY	Healthcare
BOL	Healthcare
BSX	Healthcare
CI	Healthcare
FRX	Healthcare
GDT	Healthcare
GENZ	Healthcare
HMA	Healthcare
HRC	Healthcare
HUM	Healthcare
JNJ	Healthcare
LLY	Healthcare
MDT	Healthcare
MRK	Healthcare
PFE	Healthcare
THC	Healthcare
TMO	Healthcare
UNH	Healthcare
BA	Industrial-Goods
CAT	Industrial-Goods
COL	Industrial-Goods
DE	Industrial-Goods
DOV	Industrial-Goods
EMR	Industrial-Goods
ETN	Industrial-Goods
FLR	Industrial-Goods
GD	Industrial-Goods
GR	Industrial-Goods
HON	Industrial-Goods
IR	Industrial-Goods
ITW	Industrial-Goods
LMT	Industrial-Goods
LPX	Industrial-Goods
MAS	Industrial-Goods
NOC	Industrial-Goods
PH	Industrial-Goods
PLL	Industrial-Goods
SNA	Industrial-Goods
SWK	Industrial-Goods
TNB	Industrial-Goods
TYC	Industrial-Goods
WY	Industrial-Goods
X	Industrial-Goods
ABS 	Services
AHC	Services
AMR	Services
APOL	Services
AZO	Services
BBBY	Services
BBY	Services
BJS	Services
BLS	Services
BNI	Services
CCL	Services
CMCSA	Services
CSX	Services
CTAS	Services
DAL	Services
DDS	Services
DG	Services
DIS	Services
DLX	Services
DRI	Services
FDO	Services
FDX	Services
FISV	Services
G 	Services
GCI	Services
GP	Services
GPC	Services
GPS	Services
GWW	Services
HD	Services
HET	Services
HI	Services
HLT	Services
HRB	Services
IPG	Services
JCP	Services
JNY	Services
JP	Services
KR	Services
LOW	Services
LTD	Services
LUV	Services
MAR	Services
MCD	Services
MHP	Services
NSC	Services
ODP	Services
OMC	Services
ONE	Services
PAYX	Services
R	Services
SBUX	Services
SGP	Services
SHW	Services
SPLS	Services
SVU	Services
SWY	Services
SYY	Services
TIF	Services
TJX	Services
UCL	Services
UNP	Services
UST	Services
WAG	Services
WEN	Services
WMT	Services
AAPL 	Technology
ADBE	Technology
ADCT	Technology
ADI	Technology
ALTR	Technology
AMAT	Technology
AMD	Technology
ANDW	Technology
BMC	Technology
BR	Technology
CA	Technology
CPWR	Technology
CSC	Technology
CSCO	Technology
CTL	Technology
EMC	Technology
ERTS	Technology
GLW	Technology
IBM	Technology
IGT	Technology
INTC	Technology
INTU	Technology
KLAC	Technology
LLTC	Technology
LSI	Technology
LXK	Technology
MOLX	Technology
MOT	Technology
MSFT	Technology
MU	Technology
MXIM	Technology
NOVL	Technology
NSM	Technology
NVLS	Technology
ORCL	Technology
PMTC	Technology
QCOM	Technology
S	Technology
SCH	Technology
SUNW	Technology
T	Technology
TER	Technology
TLAB	Technology
TXN	Technology
UIS	Technology
WIN	Technology
XLNX	Technology
AEP	Utilities
AT	Utilities
CIN	Utilities
CMS	Utilities
D	Utilities
DTE	Utilities
DUK	Utilities
ED	Utilities
ETR	Utilities
FPL	Utilities
GAS	Utilities
MIR	Utilities
NI	Utilities
PCG	Utilities
PEG	Utilities
PNW	Utilities
PPL	Utilities
SO	Utilities
TE	Utilities
TEK	Utilities
TXU	Utilities
APCC None
ASO	None
BCC	None
BDK	None
BGEN	None
BMET	None
BSC	None
CC	None
CMVT	None
CTX	None
CTXS	None
DCN	None
DJ	None
FD	None
FDC	None
FON	None
GDW	None
HCR	None
HDI	None
HPC	None
KRI	None
LTR	None
MEL	None
MER	None
MIL	None
MYG	None
NCC	None
PSFT	None
QTRN	None
RATL	None
RBK	None
SBC	None
SLR	None
SOTR	None
SPC	None
TOY	None
TRB	None
UPC	None
